1111111111111111
1E00000000000001
1010010000010101
1010010101000101
1P000C0000000001
1111111111111111