1111111111111111
1E00000000C00C01
1010010000010101
1010010101000101
1P00C00C00000001
1111111111111111